#############
#..?........#
#..##....#..#
#........#..#
#...........#
#..####.....#
#.....#.....#
#.....##....#
#...........#
#........#..#
#..##....#..#
#...........#
#############



