#############
#...........#
#..##.......#
#...........#
#...........#
#..##.......#
#...........#
#...........#
#...........#
#...........#
#..##.......#
#...........#
#############



