#######
#.....#
#.#.#.#
#.....#
#######
